Kaley | Torphy,
Tyler | Corkery,
Jacynthe | Frami,
Hermina | Yundt,
Austin | Schmidt,
Cristian | Dickens,
Nya | Turcotte,
Lillian | Okuneva,
Stone | Hagenes,
Jadyn | Rath,
Orville | Barton,
Reynold | Ryan,
Vance | Boyer,
Adela | Becker,
Sheldon | Larson,
Jeffrey | Gorczany,
Arnaldo | Gerlach,
Maurice | Daniel,
Golda | Aufderhar,
Reinhold | Daugherty,
Patience | Bauch,
Amely | Ernser,
Meghan | Yundt,
Mitchell | Veum,
Elwyn | Medhurst,
Diamond | Schowalter,
Hettie | McCullough,
Caleigh | Tremblay,
Gregory | Conn,
Reid | Kassulke,
Macie | Purdy,
Sunny | Hilpert,
Devyn | Kohler,
Adelbert | Herzog,
Isadore | Schuster,
Simeon | Cummerata,
Conner | Klein,
Alphonso | Strosin,
Jackson | Braun,
Kylie | Schultz,
Roslyn | Goyette,
Easter | Lockman,
Vivian | Nader,
Eugene | Marvin,
Hermann | Gaylord,
Ezra | Sauer,
Jules | Hartmann,
Gilberto | Graham,
Era | Aufderhar,
Alfredo | Kohler,
Abagail | Ortiz,
Serenity | Rohan,
Bertram | Toy,
Lyda | Simonis,
Abbie | Spencer,
Prudence | Bergstrom,
Kylie | Cartwright,
Nellie | Gaylord,
Keyshawn | Lakin,
Kennedi | Kub,
Eldred | Bartell,
Paul | Kling,
Narciso | Hansen,
Paris | Bauch,
Karson | Kilback,
Liza | Langosh,
Jayne | DuBuque,
Daphnee | Herzog,
Domenick | Bernier,
Rodrick | Hayes,
Bernice | Cummerata,
Guiseppe | Bartell,
Jeramy | Macejkovic,
Damien | Bechtelar,
Rosanna | Jones,
Vada | Reilly,
Berry | Williamson,
Valentine | Turner,
Johnny | Glover,
Zetta | Ortiz,
Sid | Christiansen,
Curtis | Kihn,
Max | Mann,
Layne | Bednar,
Viva | Mueller,
Fern | Kling,
Emerald | Sanford,
Conrad | Williamson,
Gerald | Stehr,
Abelardo | Grimes,
Douglas | Kassulke,
Vito | Bashirian,
Violette | Hyatt,
Kaia | Fisher,
Nayeli | Hilll,
Roman | Stracke,
Hailie | Feeney,
Beverly | Leannon,
Lavern | Reichel,
Coralie | Littel